212222222222222222222
212222222222222222222
212222222222222222222
212222222222222222222
212222222222222222222
212222222222222222222
212222222222222222222
212222222222222222222
212122222222222222222
212122222222222222222
211122222222222222222
222222222222222222222
